111111111111111111111111111111
100000000C0000000000000C000001
10100101C01000001010010001E101
101001001010101000100100010001
1P000000C0000000000000C0000101
111111111111111111111111111111
