111111111111111111111111111111
100000001C1000000000000C001001
10100101C01000001010010001E101
101001001010101000100100010001
101001001010101000100100010001
101001001010101000100100010001
1010010010101010001s0100010001
111101001010101000100100010001
1P000000C0000000000000C0000101
111111111111111111111111111111
